{
    "name": "entrance"
    , "walls": 
    [
        "###############################################################"
        ,"#                           #      #                          #"
        ,"#                           #      #                          #"
        ,"#                           #      #                          #"
        ,"#                           ###  ###                          #"
        ,"#                                                             #"
        ,"#                                                             #"
        ,"#                   BBBBBBB                                   #"
        ,"#                   B     B                                   #"
        ,"0                   B                                         1"
        ,"#                   B     BBBBB                               #"
        ,"#                                                             #"
        ,"#                                                             #"
        ,"#                                                             #"
        ,"#                   BB  BBB                                   #"
        ,"#                         B                                   #"
        ,"#                         B                                   #"
        ,"#                         B                                   #"
        ,"#                                                             #"
        ,"#                                                             #"
        ,"#                                                             #"
        ,"###############################################################"
    ]
    , "doors" : [
        {
            "name": "front-hall-left"
            , "playerStartX": 1
            , "playerStartY": 9
        } 
        , {
            "name": "front-hall-right"
            , "playerStartX": 61
            , "playerStartY": 9
        }
    ]
}