{
    "walls": 
    [
        "##################################################################"
        ,"#                           #      #                             #"
        ,"#                           #      #                             #"
        ,"#                           #      #                             #"
        ,"#                           ###  ###                             #"
        ,"#                                                                #"
        ,"#                                                                #"
        ,"#                   BBBBBBB                                      #"
        ,"#                   B     B                                      #"
        ,"0                   B                                            1"
        ,"#                   B     BBBBB                                  #"
        ,"#                                                                #"
        ,"#                                                                #"
        ,"#                                                                #"
        ,"#                   BB  BBB                                      #"
        ,"#                         B                                      #"
        ,"#                         B                                      #"
        ,"#                         B                                      #"
        ,"#                                                                #"
        ,"#                                                                #"
        ,"#                                                                #"
        ,"##################################################################"
    ]
    , "doors" : ["front-hall-left", "front-hall-right"]
}