{
    "name": "front-hall-left"
    , "walls": 
    [
         "###############################################################"
        ,"#                                                             #"
        ,"#                                                             #"
        ,"#                                                             #"
        ,"#                                                             #"
        ,"#                                                             #"
        ,"#                                                             #"
        ,"#                                                             #"
        ,"#                                                             #"
        ,"#                                                             0"
        ,"#                                                             #"
        ,"#                                                             #"
        ,"#                                                             #"
        ,"#                                                             #"
        ,"#                                                             #"
        ,"#                                                             #"
        ,"#                                                             #"
        ,"#                                                             #"
        ,"#                                                             #"
        ,"#                                                             #"
        ,"#                                                             #"
        ,"###############################################################"
    ]
    , "doors" : [
        {
            "name": "entrance"
            , "playerStartX": 57
            , "playerStartY": 9
        }]
}