{
    "name": "front-hall-left"
    , "walls": 
    [
         "##################################################################"
        ,"#                                                                #"
        ,"#                                                                #"
        ,"#                                                                #"
        ,"#                                                                #"
        ,"#                                                                #"
        ,"#                                                                #"
        ,"#                                                                #"
        ,"#                                                                #"
        ,"#                                                                0"
        ,"#                                                                #"
        ,"#                                                                #"
        ,"#                                                                #"
        ,"#                                                                #"
        ,"#                                                                #"
        ,"#                                                                #"
        ,"#                                                                #"
        ,"#                                                                #"
        ,"#                                                                #"
        ,"#                                                                #"
        ,"#                                                                #"
        ,"##################################################################"
    ]
    , "doors" : [
        {
            "name": "entrance"
            , "playerStartX": 60
            , "playerStartY": 9
        }]
}